1111111111111111111111111111111111111111111111111111111111111111111111111111111111111111111
1P0000000E0000000000000C00000000000000C00000000000000C00000000000000C000000000C000000000001
1111111111111111111111111111111111111111111111111111111111111111111111111111111111111111111
