NO ./img/north_wall_1200.xpm
SO ./img/south_wall_1200.xpm
WE ./img/west_wall_1200.xpm
EA ./img/east_wall_1200.xpm

F 220,100,0
C 225,30,0

111111111111111111
                 1
1111111111111111 1
10000000000000N1 1
1111111111111111 1
1              1 1
11111111111111 1 1
1              1 1
1111111111111111 1
1E1              1
111111111111111111