NO ./img/north_wall_64.xpm
SO ./img/south_wall_64.xpm
WE ./img/west_wall_64.xpm
EA ./img/east_wall_64.xpm

F 211,211,211
C 176,224,230

        1111111111111111111111111
        1000000000110000000000001
        101100001110000000000001
        1001000000000000000000001
1111111110110000011100000000000011
10E000000011000001110111100011111
11110111111111011100000010001111111
11110111111111011101010010001
11000000110101011100000010001
10000000000000001100000010001
10000000000000001101010010001
110000011101010111110111100111
11110111 1110101 101111010001
11111111 1111111 111111111111
