11111111111
1E100010C01
10101010101
101010101M1
10101010101
100010001P1
11111111111