111111
1001C1
1PM1E1
100C01
111111
